11111111111111111111
101E0000011010000001
10000001000000010001
100000000001P0010001
10101000011010100001
11111111111111111111
