1111111111
0110001111
1111111111
