1111111111
1P100C0001
1010000E01
1010C00001
1111111111
