1111111111
1P10000001
1010000E01
1010000001
1111111111
