11111111111111111111
101E000001101000C001
10C00001000000010001
101010001101010000C1
10000C000001P0010001
10101000011010100001
11111111111111111111
