1111111111
1E100C0001
1000010P01
1010C00001
1111111111
